# Map

11@AAE1A111F1E1@
1@@1B1A11F1I000B
1100000000000001
@B00000000001001
1100111A111@1001
110000FE10001001
B10000212000000E
11000011E000E001
E@001D11@11BB00D
AF0000000000D001
110000000000100C
1B00000000000001
B1D1111AD11H0001
11A111111E1ABA11
11B11C111@CDCCBC
1DF1BF111B1111AB

# Events

5 6 4

# Teleporters

8 6 "data/dungeon5.txt" 8 6
6 6 "data/dungeon3.txt" 6 6
