# Map

11111F111DBD@AEC
E1@1DFF1F1D1BB1A
1E1E11D1B11A1@11
1111E11EBD11B111
1111D1FF1C1C111A
111DFBC@B11BB11D
1A1A1BB121B1111E
E11BADD0I011B1EF
1AE1@11000A111D1
A@AD1110001B1B11
FC1D1DE000ACEEBB
1111FB@000ED11F1
11110000000001C@
1B@100000000I111
1D1F00000000G1D1
A1@111CB>1B1A1F1

# Events

8 7 4

# Teleporters

8 6 "data/dungeon4.txt" 8 6
