# Map

1011111111111111
1001110110000001
1100110000001102
1110000111100001
1000111110111111
1011111110111111
1011111110111111
1001110110011101
1100110111001101
1110000000000001
1011111110111111
1011111110111111
1011111110111111
1001110000011101
1100000111000001
1111111111111111

# Events

0 3 0
1 3 2
0 3 4

# Teleporters

15 2 "data/map2.txt" 1 2