# Map

1111111221111111
1000111001110001
1000110000110001
1000000000110001
1101150000010111
1001101101510011
1001001001111011
1000001050111001
1111011000111001
1005010011101001
1000010000101501
1011011001101101
1011000000001001
1011000000111001
1000010000000001
1111111211111111

# Events

5 4 0
10 5 0
13 10 0
3 9 0
8 7 0

# Teleporters

7 15 data/???.txt 0 0
7 0 data/outside.txt 7 13
8 0 data/outside.txt 8 13
