# Map

1211111111111111
1001110110011101
1000110000001101
1110000111100101
1000111110001111
1011111110111111
1011111110111111
1001110110011101
1100000111001101
1111000011111101
1000011000111111
1000111100000111
1011111110111111
1001111110111101
1100110110001101
1111111111111111

# Teleporters

1 2 "data/map1.txt" 14 2